10
10
w,w,w,w,w,w,w,w,w,w
w,a,f,f,f,f,f,f,s,w
w,f,f,f,f,f,f,f,f,w
w,f,f,f,f,f,f,f,f,w
w,f,f,f,s,f,f,f,f,w
w,f,f,f,f,f,f,f,s,w
w,f,f,f,f,f,f,f,f,w
w,f,f,f,f,f,f,f,f,w
w,s,f,f,f,f,f,f,g,w
w,w,w,w,w,w,w,w,w,w